========================================
|>|             |              =====|  |
|               |  |                |  |
| |======  == = |  |=========       |  |
|               |  |        | |     |  |
|========       |           | |     |  |
||      |       |======     | |     |  |
||      |   | |       |     | |     |  |
||      |   | |====         | |        |
||      |   | |             | |        |
|       |             |=======|  |===| |
|       |             |     | |  |   | |
|       |             |     | |  |===| |
|       |===========  |  ===|          |
|                  |  |  |     ===|    |
|                  |  |           |    |
|  |=   =|         |  |      |         |
| |=     =|        |===      |===      |
| |       |                            |
=====|<|================================